111111111111111111111111111111111
100000000000000000000000000000001
10000000000000000C000000000000001
1E0000000010111001110111000000001
10000C000010001000010001000C00001
100000000010111001110001000000001
10000P000010001000010C01000000001
1000000000101110011100010000000C1
100000000000000000000000000000001
1000000000C0000C00000000000000001
111111111111111111111111111111111
