111111111111111111111111111111111
100000000000000000000000000000001
100000000000C000000C0000000000001
1E0000000010111001110111000000001
100C00000010001000010001000000001
1000000000101110011100010000C0001
10000P000010001000010C01000000001
100000000010111001110001000000001
10000000000000000000000000C000001
1000000000000C000000C000000000001
111111111111111111111111111111111
